1111111111111111111
1000000100000000001
1000000100000000001
1011100100000000001
10100P0100000000001
1110000111111111111
1000000110000000001
1111111111111111111
