11111111
10000001
10000001
10111001
10100001
11111111
